name,tel,eng,mat,sci,total,avg
Anonymous,98,89,98,88,373,93.25
rajesh,88,77,87,89,341,85.25
rakesh,65,66,77,88,296,74.0
sumit,66,77,64,89,296,74.0
suraj,66,61,76,87,290,72.5
tanisha,77,66,56,87,286,71.5
manoj,65,66,88,56,275,68.75
ashish,45,65,76,78,264,66.0
ratish,66,55,66,74,261,65.25
raj,65,45,65,76,251,62.75
manish,65,45,45,45,200,50.0
rohini,65,67,6,55,193,48.25
Anonymous,22,23,34,32,111,27.75
